NO ./textures/north.tex
SO ./textures/south.tex
WE ./textures/west.tex
EA ./textures/east.tex

F 15, 148, 17
C 32,128,255

11111111111111111111111111111111111111
10000000000000000000000000000000000011
10000000000000000000000000000000000011
10000000000000000000000000000000000011
10000000000000000000000000000000000011
10000000000000000000000000000000000011
10000000000000000000000000000000000011
10000000000000000000000000000000000011
10000000000000000000000000000000000011
10000000000000000000000000000000000011
10000011111000000000000000000000000011
10000010001000000000000000000000000011
10000010W01000000000000000000000000011
10000010001000000000000000000000000011
100101101110000000000000000000000011111111111
100101101000000000000000000000000011111111111
100101101000000000000000000000000011111111111
100101101000000000000000000000000011111111111
100101101000000000000000000000000011111111111
10010000100000000000000000000000001
10011113100000000000000000011111111
10000000000000000000000000011111111
100M0020000000000000000000011111111
100M0030000000000000000000011111111
100M0020000000000000000000011111111
10000000000000000000000000011111111
10000000000000000000000000011111111
100000000000000000000000000100000000001
100000000000000000000000000100000000001
100000000000000000000000000100000000001
100000000000000000000000000100000000001
100000000000000000000000000100000000001
100000000000000000000000000100000000001
100000000000000000000000000100000000001
100000000000000000000000000100000000001
1000000000000000000000000001111
100000000000000000000000000100000000001
100000000000000000000000000100000000001
100000000000000000000000000100000000001
100000000000000000000000000100000000001
100000000000000000000000000100000000001
100000000000000000000000000100000000001
100000000000000000000000000100000000001
100000000000000000000000000100000000001
1000000000000000000000000001111
100000000000000000000000000100000000001
100000000000000000000000000100000000001
100000000000000000000000000100000000001
100000000000000000000000000100000000001
100000000000000000000000000100000000001
100000000000000000000000000100000000001
100000000000000000000000000100000000001
100000000000000000000000000100000000001
1000000000000000000000000001111
100000000000000000000000000100000000001
100000000000000000000000000100000000001
100000000000000000000000000100000000001
100000000000000000000000000100000000001
100000000000000000000000000100000000001
100000000000000000000000000100000000001
100000000000000000000000000100000000001
100000000000000000000000000100000000001
1000000000000000000000000001111
111111111111111111111111111111